a = indefinite article, not used in esperanto.
aback, to take = surprizi.
abaft = posta parto.
abandon = forlasi.
abase = humiligi. [error in book: humilgi]
abash = hontigi.
abate (lower) = mallevi.
abate (speed) = malakceli.
abbey = abatejo.
abbot = abato.
abbreviate = mallongigi.
abdicate = demeti la reĝecon.
abdomen = ventro.
abduct = forrabi.
abduction = forrabo.
abed = lite.
aberration = spiritvagado.
abet = kunhelpi.
abhor = malamegi.
abhorrence = malamego.
abide = loĝi (resti).
ability = lerteco.
ability = talento.
abject = humilega.
abjure = malkonfesi, forĵuri.
ablative = ablativo.
able, to be = povi.
able (skilful) = lerta.
abnegation = memforgeso.
aboard = en ŝipo.
abode = loĝejo.
abolish = neniigi.
abominable = abomena.
abomination = abomeno.
abound = sufiĉegi.
about (prep.) = ĉirkaŭ.
about (adv.) = ĉirkaŭe.
above (prep.) = super.
above (adv.) = supre.
above all = precipe.
abreast = flanko ĉe flanko.
abridge = mallongigi.
abridgement = resumo.
abroad = eksterlande.
abrupt = subita.
abscess = absceso.
abscond = sin forkaŝi.
absent, to be = foresti.
absence = foresto—ado.
absolute = absoluta.
absolutely = absolute.
absolution = senkulpigo.
absolution (from sin) = senpekigo.
absolve = senkulpigi.
absolve (from sin) = senpekigi.
absorb = sorbi.
absorption = sorbo.
abstain = deteni sin.
abstemious = sobrema.
abstinence = deteno.
abstinent = detenema.
abstract (abridgement) = resumo.
abstract = abstrakti.
abstracted = abstrakta.
abstruse = tre malklara.
absurd = absurda.
absurdity = absurdo.
abundance = sufiĉego.
abuse = trouzi.
abuse = trouzo.
abyss = profundegaĵo.
acacia = akacio.
academic = akademia.
academy = akademio.
accede = konsenti.
accelerate = akceli.
accent (sign, mark) = signo.
accent = akcenti.
accent = akcento.
accentuate = akcentegi.
accept = akcepti.
acceptable = akceptebla.
acceptance = akceptaĵo.
acceptation = akcepto.
access = aliro.
accession = plimultigo.
accessory = kunhelpanto.
accident (chance) = okazo.
accident (injury) = malfeliĉo.
acclamation = aplaŭdego.
acclimatize = alklimatigi.
acclivity = supreniro.
accommodate = alfari.
accompany = akompani.
accomplice = kunkulpulo.
accomplish = plenumi.
accomplished (of things) = elfarita.
accomplishment = talento.
accord (music) = akordo.
accord = konsento.
according to = laŭ.
accouchement = akuŝo.
account (bill) = kalkulo.
account = rakonto.
accountable, to be = respondi pri.
accountant (profn.) = kalkulisto.
account (current) = konto kuranta.
accounts = kalkularo.
account (rendered) = raporto.
accoutre (milit.) = armi.
accrue = kreskiĝi.
accumulate = amasigi.
accumulation = amaso.
accuracy = akurateco.
accurate = akurata.
accursed = malbena.
accusation = kulpigo.
accusative = akuzativo.
accuse = kulpigi.
accustomed, to be = kutimi.
ace = aso.
acerbity = acideco.
acetous = acida.
ache = doloro.
achieve = plenumi.
achievement = elfaro.
acid = acida.
acid = acido.
acidity = acideco.
acidulous = acideta.
acknowledge = konfesi.
acknowledge (letters, etc.) = avizi.
acknowledgement (letters, etc.) = avizo.
acknowledgment = konfeso.
aconite = akonito.
acorn = glano.
acoustics = akustiko.
acquaint = sciigi.
acquaintance = konato.
acquainted, to be = konatiĝi.
acquiesce = konsenti.
acquire = akiri.
acquirement = akiro.
acquisition = akiraĵo.
acquit (debt) = kvitanci.
acquit (blame) = senkulpigi.
acrid = acida.
acrimonious = akretema.
acrobat = ekvilibristo.
across = trans.
act = agi.
act (statute) = regulo, leĝo.
act (drama) = akto.
action, to bring an = procesi.
active = aktiva. [error in book: activa]
activity = aktiveco.
actor = aktoro.
actor (drama) = komediisto.
actual (time) = nuna.
actual = reala.
actuality = nuneco, realeco.
actuated = incitita.
acumen = sagaceco.
acute = akra.
acuteness = sagaceco.
adage = proverbo.
adapt = alfari.
adaptation = alfarado.
add up = sumigi.
add together = kunmeti.
add to = aldoni.
addendum = aldono.
adder = kolubro.
addicted, to be = kutimi.
addition = aldono.
additional = aldona.
addled = senfrukta.
address = adresi.
adduce = prezenti.
adept = adepto.
adequate = sufiĉa.
adhere = aliĝi.
adherent = aliĝulo.
adhesion = aliĝo.
adhesive = glua.
adieu = adiaŭ.
adjacent = apuda.
adjective = adjektivo.
adjoining = apuda.
adjourn = prokrasti.
adjudge = aljuĝi.
adjure = petegi.
adjust = aranĝi, almezuri.
administer = administri.
administration = administracio.
admirable = admirinda.
admiral = admiralo.
admiration = admiro.
admire = admiri.
admission = allaso.
admissible = permesebla.
admit = allasi.
admonish = admoni.
admonition = admono.
adolescence = juneco.
adolescent = junulo.
adopt = alpreni.
adopt (child) = filigi.
adore = adori.
adorn = ornami.
adroit = lerta.
adroitness = lerteco.
adulation = adulacio, flato.
adult = plenkreskulo.
adult = plenkreska.
adulterate = falsi.
adultery = adulto.
adultery, to commit = adulti.
advance = antaŭeniri.
advancement = progreso.
advantage = utilo, profito.
advantageous = utila, profita.
advent = advento.
adverb = adverbo.
adversary = kontraŭulo.
adverse = kontraŭa.
adversity = kontraŭeco.
advert to (to) = aludi (al).
advertise = anonci.
advertisement = anonco.
advice = konsilo.
advise = konsili.
advocate = defendi.
aerial = aera.
aerolite = aerolito.
aeronaut = aerveturanto.
afar = malproksime.
affable = afabla.
affability = afableco.
affair = afero.
affected (manner) = afekta.
affected, to be = afekti.
affecting (touching) = kortuŝanta.
affection = afekteco.
affection (love) = amo.
affectionate = aminda.
affectionately = aminde.
affinity (relationship) = parenceco.
affiliate = aligi, anigi.
affiliated, to become = aliĝi, aniĝi.
affirm (attest) = atesti.
affirm (assure) = certigi.
affirmation = atesto.
affirmation = certigo, jeso.
affirmative = jesa.
affix = afikso.
afflict = malĝojigi.
affluence = riĉeco.
affluent = riĉega.
afford, to give = doni.
affray = batiĝo.
affright = timigi.
affront = insulto.
afloat = flose, naĝe.
afraid = timigita.
aft = posta parto.
after = post.
aftermath = postfojno.
afternoon = posttagmezo.
afterwards = poste.
again = ree.
against = kontraŭ.
agate = agato.
age = aĝo.
aged = maljuna.
agency = agenteco.
agenda = memorlibro.
agent = agento.
aggrandize = pligrandigi.
aggrandisement = pligrandigo.
aggravate = plimalbonigi.
aggression = atako.
aggressor = atakanto.
aghast = terurega.
agile = facilmova.
agitate = agiti.
ago = antaŭ.
agonize = agonii.
agony = agonio.
agree = konsenti.
agreeable = agrabla.
agreement (deed) = kontrakto.
agreement = interkonsento.
agriculture = terkulturo.
agriculturist = terkulturisto.
agronomy = agronomio.
ague = febreto.
ah! = ha!
ahead = antaŭe.
aid = helpo.
aide-de-camp = adjutanto.
ail = malsani.
ailment = malsano.
aim (purpose) = celo.
air (appearance) = mieno.
air (music) = ario.
air = aerumi.
air (atmosphere) = aero.
airball (toy) = pilkego.
airballoon = aerostato.
airhole = fenestreto.
airpump = aeropumpilo. [error in book: aeropompilo]
aisle = flankaĵo.
ajar = duonfermita.
akin = parenca.
alabaster = alabastro.
alacrity = rapideco.
alarm = maltrankviligi.
alarum (clock) = vekhorloĝo.
alas! = ho ve!
albeit = kvankam.
album = albumo.
albumen = albumeno.
alchemy = alĥemio.
alcohol = alkoholo.
alcoholic = alkohola.
alcoholism = alkoholismo.
alcove = alkovo.
alder (tree) = alno.
ale = biero.
alert = vigla.
algebra = algebro.
alias = alie.
alien = alilandulo.
alike = simila.
aliment = manĝaĵo.
alimony = nutramono.
alive = viva.
alkali = alkalio.
all (every one) = ĉiu, ĉiuj (plur.).
allay = trankviligi, kvietigi.
allege = pretendi.
allegiance = fideleco.
allegory = alegorio.
alleviate = dolĉigi.
alley = aleo, strateto.
alliance = interligo.
allocution = paroladeto.
allot = lotumi.
allotment = lotaĵo.
allow = permesi.
allowance (a/c) = dekalkulo.
allowance (share) = porcio.
all-powerful = ĉiopova.
allude = aludi.
allure = logi.
allurement = logo.
allusion = aludo.
alluvial = akvemetita.
ally = interligi.
almanac = almanako.
almighty = ĉiopova.
almost = preskaŭ.
almond = migdalo.
alms = almozo.
almshouse = maljunulejo.
aloes = aloo.
aloft = supre.
alone = sola (adj.), sole (adv.).
along with = kune kun.
aloof, to keep = eviti.
aloud = laŭte.
alphabet = alfabeto.
alps = alpoj.
already = jam.
also = ankaŭ.
altar = altaro.
alter = aliigi.
alteration = aliigo.
altercation = malpaco.
alternate = alterni.
alternative = elekteco.
althea = alteo.
although = kvankam.
altitude = alto.
alto = aldo.
altogether = tute.
alum = aluno.
always = ĉiam.
amalgam = amalgamo.
amalgamate = unuigi.
amalgamation = unuigo.
amanuensis = skribisto.
amass = amasigi.
amateur = nemetiisto.
amaze = miregigi.
amazed, to be = miregiĝi.
amazement = mirego.
amazing = miriga.
amazon = rajdantino.
ambassador = ambasadoro.
amber = sukceno.
ambiguous = dusenca.
ambition = ambicio.
ambitious = ambicia.
amble = troteti.
ambrosia = ambrozio.
ambulance (place) = malsanulejo.
ambuscade = embusko.
ambush = embuski.
ameliorate = plibonigi.
amend = reformi.
amends, to make = rekompenci.
america = ameriko.
american = amerikano.
amiability = amindeco.
amiable = afabla, aminda.
amicably = pace.
amid = meze.
amidst = meze.
amity = amikeco.
ammonia = amoniako.
among = inter.
amongst = inter.
amorous = amema.
amount = sumo.
amphibious = amfibia.
amphitheatre = amfiteatro.
amphora = amforo.
ample = sufiĉa.
amplify = grandigi.
amplitude = amplekso.
amputate = detranĉi.
amulet = talismano.
amuse = amuzi.
anagram = anagramo.
analogy = analogio.
analysis = analizo.
analyze = analizi.
anarchy = anarĥio.
anatomy = anatomio.
ancestors = praavoj, prapatroj.
anchor = ankro.
anchorite = dezertulo.
ancient = antikva.
and = kaj.
anecdote = rakonteto.
anew = ankoraŭ, ree.
angel = anĝelo.
angelic = anĝela.
anger = kolero.
anger = kolerigi.
angle (corner) = angulo.
angling = fiŝkaptado.
angle (fish) = fiŝkapti.
angler = fiŝkaptisto.
angry, to be = koleri.
anguish = dolorego.
angular = angula.
animal = besto.
animate = vivigi.
animated = vivigita.
animating = viviga.
animation = viveco.
animosity = malamikeco.
aniseed = anizo.
anisette = anizlikvoro.
ankle = maleolo.
annals = historio.
annex = kunigi.
annexation = kunigo.
annihilate = neniigi.
anniversary = datreveno.
annotate = noti.
announce = anonci.
announcement = anonco.
annoy = ĉagreni.
annoyance = ĉagreno, enuo.
annual (publication) = jarlibro.
annual (yearly) = ĉiujara.
annuity = jarpago.
annul = nuligi.
annular = ringforma.
annunciation = anunciacio.
anoint = ŝmiri.
anointing = ŝmiro, ado.
anomaly = anomalio.
anonymous = anonima.
answer = respondi.
answer (affirmatively) = jesi.
answerable for, to be = respondi pri.
ant = formiko.
antagonist = kontraŭulo.
antarctic = antarktika.
antecedents = antaŭaĵo.
antechamber = antaŭĉambro.
antedate = antaŭdatumi.
antelope = antilopo.
anterior = antaŭa.
anteroom = antaŭĉambro.
anthem = antemo, himnego.
ant-hill = formikejo.
anthropology = antropologio.
antichrist = antikristo.
anticipate = antaŭvidi.
antidote = kontraŭveneno.
antimony = antimono.
antipathy = antipatio.
antipodes = antipodoj.
antiquary = antikvisto.
antiquated = antikva.
antique = antikva.
antique (noun) = antikvaĵo.
antiquity = antikveco.
antler = kornbranĉo.
anvil = amboso.
anxiety = maltrankvileco.
anxious = maltrankvila.
any = ia.
anybody = iu.
anyhow = iel.
anyone = iu.
anyone's = ies.
any quantity = iom.
anything = io.
anywhere = ie.
aorta = aorto.
apace = rapide.
apart = aparte.
apartment = ĉambro.
apathetic = apatia.
apathy = apatio.
ape = simio.
ape (verb) = imiti.
aperient = laksileto.
aperture = malfermaĵo.
apex = pinto, suprapinto.
apiary = abelejo.
apish = simia.
apocryphal = apokrifa.
apogee = apogeo.
apologise = pardonon peti.
apologue = apologo.
apology = apologio.
apoplexy = apopleksio.
apostle = apostolo.
apostolic = apostola.
apostrophe = apostrofo.
apostrophize = alparoli.
apothecary = apotekisto.
apothecary's = apoteko.
apotheosis = apoteozo.
appal = terurigi.
apparatus = aparato.
apparel = vesto.
apparent = videbla.
apparition = apero.
apparitor (beadle) = pedelo.
appeal = alvoki.
appear (come in sight) = aperi.
appear = ŝajni.
appearance (aspect) = vidiĝo, mieno.
appearance, to put in an = ĉeesti.
appease = pacigi.
append = aldoni.
appendage = aldonaĵo.
appendix = aldono.
appetising = apetitdona.
appetite = apetito.
applaud = aplaŭdi.
applause = aplaŭdo—ado.
apple = pomo.
apple tree = pomarbo, pomujo.
appliance = aparato.
application = atento.
apply (to put on) = almeti.
apply to = sin turni (al).
appoint (nominate) = nomi.
appointment = elekto.
apportion = lotumi, dividi.
appraise = taksi.
appreciate = ŝati.
apprehend (seize) = ekkapti.
apprehend (understand) = kompreni.
apprehension (fear) = timo.
apprentice = lernanto.
apprenticeship = lernado.
apprise = sciigi, informi.
approach = proksimiĝi.
approaching (time) = baldaŭa.
approbation = aprobo.
appropriate, to be = difinita por.
appropriate (take, keep) = proprigi.
approval = aprobo.
approve = aprobi.
approximate (time) = baldaŭa.
apricot = abrikoto.
april = aprilo.
apron = antaŭtuko.
apt = kapabla.
aptitude = kapableco.
aptly = kapable.
aquatic = akva.
aqueduct = akvokonduko.
aqueous = akva.
arab = arabo.
arable = plugebla.
arbitrary = arbitra.
arbitrate = arbitracii.
arbitration = arbitracio.
arbitrator (profn.) = arbitraciisto.
arbour = laŭbo.
arc = arko.
arcade = arkado.
arch = arko.
arch = arkefleksi.
archangel = ĉefanĝelo.
archæology = arĥeologio.
archbishop = ĉefepiskopo.
archduke = arĥiduko.
archer = pafarkisto.
archipelago = insularo.
architect = arĥitekturisto.
architecture = arĥitekturo.
archives = arĥivo.
arctic = arktika.
ardent = fervora.
ardour = fervoro.
arduous = laborega.
arena = areno.
areopagus = aeropago.
argue = argumenti.
argument = argumento.
arid = seka.
aright = bone.
arise = leviĝi.
aristocracy = aristokrataro.
aristocrat = aristokrato.
arithmetic = aritmetiko.
ark = ŝipego.
arm (milit.) = armi.
arm (of the body) = brako.
armament = armilaro.
armchair = seĝego.
armistice = interpaco.
armlet = ĉirkaŭbrako.
armorials = insigno.
armour = armaĵo.
armourer = armilfaristo.
armoury = armilejo.
armpit = subbrako.
arms (weapons) = armiloj, bataliloj.
army (military) = militistaro.
army (non-military) = armeo.
army-corps = korpuso.
arnica = arniko.
aroma = aromo.
aromatic = aroma.
around (prep.) = ĉirkaŭ.
around (adv.) = ĉirkaŭe.
arouse = veki.
arpeggio = arpeĝo.
arraign = kulpigi.
arrange = aranĝi.
arrant = fama.
array (deck out) = ornami.
arrears, in = malantaŭe.
arrest = aresti.
arrival = alveno.
arrive (on foot) = alveni.
arrive (by vehicle) = alveturi.
arrogance = aroganteco.
arrogant = aroganta.
arrow = sago.
arsenal = armilejo.
arsenic = arseniko.
arson = brulkrimo.
art = arto.
artery = arterio.
artful = ruza.
arthritic = artritulo.
artichoke = artiŝoko.
article = artikolo.
article (commerce) = komercaĵo.
articulate = elparoli.
articulation (anat.) = artiko.
artifice = artifiko.
artificial = artefarita.
artillery = artilerio.
artisan = metiisto.
artist = artisto.
artless = simplanima, naiva.
artlessness = naiveco.
as = kiel.
as—as = tiel—kiel.
ascend = supreniri.
ascension (feast of) = ĉieliro.
ascension = suprenirado.
ascent = supreniro.
ascertain = certiĝi.
ascribe = aligi al.
ashamed, to be = honti.
ashes = cindro.
ashpan = cindrujo.
asia = azio.
asiatic = aziano.
aside = aparte.
as if = kvazaŭ.
ask = demandi.
ask (beg) = peti.
asleep = dormanta (adj.), dormante (adv.).
as long as = tiel longe kiel.
as many = tiom.
as much = tiom.
as many as = tiom, kiom.
as much as = tiom, kiom.
asp = aspido.
asparagus = asparago.
aspect = vidiĝo.
aspect (phase) = fazo.
aspen = tremolo.
asperse = kalumnii.
asphalte = asfalto.
asphyxia = asfiksio.
aspirate = elspiri.
aspirant = aspiranto.
aspiration (breathing) = elspiro—ado.
aspiration (aim, intention) = celo.
aspire = celi.
ass = azeno.
assail = ataki.
assailant = atakanto.
assassin = mortiganto.
assault = atako.
assay = provo.
assemble = kunveni, kunvoki.
assembly = kunveno, aŭditorio.
assent = konsenti, jesi.
assert = certigi.
assess = taksi.
assessment = takso.
assiduous = diligenta.
assign = asigni.
assignment = asigno.
assimilate = similigi.
assist = helpi.
assist (at) = ĉeesti (ĉe).
assistance = helpo.
assistant = helpanto.
assistant-master = submajstro.
associate = kunulo.
association = societo.
assort = dece kunmeti.
assuage = dolĉigi.
assume = supozi.
assurance, self = memfido.
assure = certigi.
assure (life etc.) = asekuri.
asterisk = steleto.
asthma = malfacila spirado.
astonish = mirigi.
astonished, to be = miri.
astonishing = mira.
astonishment = miro.
astound = miregi.
astral = astra.
astray, to go = erariĝi.
astringent = kuntira.
astrologer = astrologiisto.
astrology = astrologio.
astronomer = astronomiisto.
astronomy = astronomio.
astute = ruza.
asunder = aparte.
asylum = rifuĝejo.
at = ĉe, je.
at (house of) = ĉe.
at all events = kio ajn okazos.
at any time = iam.
atheist = ateisto.
atheism = ateismo.
athletic = atleta.
athlete = atleto.
atlas = landkartaro.
atmosphere = atmosfero.
atom = atomo.
atomism = atomismo.
at once = tuj.
atone = rebonigi.
atonement = rebonigo.
atrocious = kruelega.
atrocity = kruelego.
atrophy = atrofio.
attach = alligi.
attachment = alligo.
attack = atako.
attack = ataki.
attain = atingi.
attain (to) = trafi, atingi (al).
attainment = akiro.
attempt = atenci.
attempt = atenco.
attendants (retinue) = sekvantaro.
attend (on) = servi.
attention, to call (to) = atentigi (al).
attention, to pay = atenti.
attention = atento.
attentive = atenta.
attest (a document) = subskribi.
attest = atesti.
attestation = atesto.
attic = tegmentĉambro.
attire = vestaĵo.
attitude = sintenado.
attorney = advokato.
attract = altiri.
attract (entice) = logi.
attraction = logaĵo.
attractive = ĉarma.
attribute (v.) = aligi al.
attribute (quality) = eco.
auction = aŭkcia vendo.
audacious = maltimega.
audacity = maltimego.
audible (adj.) = aŭdebla.
audience (interview) = aŭdienco.
audience (congregation) = aŭditorio.
audit = kontekzameni.
auditorium = aŭskultejo.
auger = borilego.
aught (anything) = io.
augment = plimultigi, pliigi.
august (month) = aŭgusto.
august = nobla.
aunt = onklino.
aureola = aŭreolo.
au revoir = ĝis revido.
auriferous = orhava.
auscultate = subaŭskulti.
auspices = aŭspicioj.
auspicious = favora.
austere = severmora.
austerely = severmore.
austerity = severmoreco.
australia = aŭstralio.
austrian = aŭstro.
authentic = vera, verega.
authenticate = verigi.
author = aŭtoro.
authorise (permit) = permesi.
authorities (of town, etc.) = estraro.
authority = aŭtoritato.
autocrat = aŭtokrato.
automatic = aŭtomata.
automobile = aŭtomobilo.
autumn = aŭtuno.
auxiliary = helpanto (noun), helpa (adj.).
avalanche = lavango.
avarice = avareco.
avaricious = avara.
avaunt = for de tie ĉi!
avenge = venĝi.
avenue = aleo.
average (n.) = mezonombro. meza kvanto.
averse = antipatia, kontraŭa.
aversion = antipatio, kontraŭo.
avert = deturni.
avidity = avideco.
avid = avida.
avoid = eviti.
avow = konfesi.
avowal = konfeso.
await = atendi.
awake = veki.
awake (intrans.) = vekiĝi.
awaken = veki.
award = aljuĝi.
aware, to be = scii.
away! = for!
away = malproksime.
awe = teruro, timego.
awful = terura.
awkward = mallerta, malgracia.
awl = borileto.
awning = sunŝirmilego.
awry = malrekta.
axe = hakilo.
axis = akso.
axle = akso.
axle-tree = akso.
axiom = aksiomo.
ay (yes) = jes.
aye (always) = ĉiam.
azote = azoto.
azure = lazuro.



babble = babili.
babe = infaneto.
baboon = paviano.
baby = infaneto.
bachelor = fraŭlo.
back (of body) = dorso.
back (reverse side) = posta flanko.
back (behind) = poste.
backbite = kalumnii.
backbone = spino.
backslider = rekulpulo.
backward (slow) = mallerta.
bacon = lardo.
bad, ly = malbona, e.
badge = simbolo.
badger = melo.
bag = sako.
bagatelle (trifle) = bagatelo.
baggage = pakaĵo.
bail = garantiaĵo.
bailiff (legal) = juĝa persekutisto.
bait = allogaĵo.
bake = baki.
baker = panisto, bakisto.
balance (scales) = pesilo.
balance (poise) = balanci.
balance of a/c = restaĵo.
balance-sheet = bilanco.
balcony = balkono.
bald = senhara.
baldness = senhareco.
bale = pakego.
baleful = pereiga.
balk = malhelpi.
ball (globe) = globo.
ball (playing) = pilko.
ball (party) = balo.
ball (bullet) = kuglo.
ballad = balado.
ballast = balasto.
ballet = baleto.
balloon = aerostato.
balloon (plaything) = aerpilkego.
ballot = voĉdoni.
balm = balzamo.
balm-mint = meliso.
balsam = balzamo.
balustrade = balustrado.
bamboo = bambuo.
banana = banano.
band (strap) = ligilo.
band (gang, troop) = bando.
bandage = bandaĝi.
bandit = malbonulo, rabulo.
bane = pereigo.
baneful = pereiga.
banish (exile) = ekzili.
banish (send away) = forpeli.
bank (money) = banko.
bank (river) = bordo.
bank (sand) = sablaĵo.
bank (note) = banka bileto.
banker = bankiero.
bankrupt = bankroto.
bankrupt, to become = bankroti.
banner = flago, standardo.
banns = edziĝanonco.
banquet = festeno.
banter = moki.
baptism = bapto.
baptize = bapti.
bar = bari.
barbarian = barbaro.
barbarism = barbarismo.
barber = barbiro.
bard = bardo.
bare = nuda.
barefoot = nudpiede.
bargain = marĉandi.
barge = ŝarĝbarko.
bark (ship) = barko.
bark (of dog) = hundobleko, bojo.
bark (of tree) = ŝelo.
bark (a tree) = senŝeligi.
barley = hordeo.
barm = feĉo.
barn = garbejo.
barometer = barometro.
baron = barono.
barrack = soldatejo.
barrel = barelo.
barrel-organ = gurdo.
barren = senfrukta.
barrenness = senfrukteco.
barricade = barikado.
barrier = barilo.
barrister = advokato.
barrow = puŝveturilo.
barter = interŝanĝi.
barytone = baritono.
basalt = bazalto.
base = fundamento.
base (mean) = malnobla.
basely = perfide.
baseless = senfundamenta.
basement = subetaĝo.
baseness = perfideco.
bashful = modesta.
basin = pelvo.
basis = fundamento.
basket = korbo.
bass (music) = baso.
bastard = bastardo.
baste = surverŝi.
bastion = bastiono.
bat (animal) = vesperto.
bath = banilo.
bathe = bani sin.
baths (place) = banejo.
battalion = bataliono.
battery (milit.) = baterio.
battle = batalo.
battle, fight a = batali.
battledore = pilkraketo.
bauble = bagatelo.
bawl = kriegi.
bay (geog.) = golfeto.
bay (bark) = hundobleki, boji.
bay, to keep at = repuŝi.
bayonet = bajoneto.
bazaar = bazaro.
be = esti.
be, able to = povi.
be, obliged to = devi.
be, willing to = voli.
beach = marbordo.
beacon = lumturo.
bead = globeto.
beadle = pedelo.
beak = beko.
beam (timber) = trabo.
beam (light) = radio.
beam (of scales) = vekto.
bean = fabo.
bear (animal) = urso.
bear, give birth to = naski.
bear with = suferi.
bearable = tolerebla.
beard = barbo.
beardless = senbarba.
bearer = alportanto.
beast (animal) = besto.
beast (brute) = bruto.
beastly = bruta.
beat = bati.
beat (with a rod) = vergi.
beatitude = feliĉegeco.
beau = koketulo.
beautiful = bela.
beauty = beleco.
bearer = kastoro.
because = ĉar, tial ke.
beckon = signodoni.
become = iĝi, fariĝi.
becoming = konvena, deca.
bed = lito.
bed (horse) = pajlaĵo.
bed (garden) = bedo.
bed (river) = kuŝujo.
bedding = litaĵo.
bedroom = dormoĉambro.
bedstead = kuŝejo.
bee = abelo.
beehive = abelujo.
beech-tree = fago.
beef = bovaĵo.
beer = biero.
beet (root) = beto.
beetle = skarabo.
befall = okazi.
befitting = deca.
before (prep.) = antaŭ.
before (adv.) = antaŭe.
before (conj.) = antaŭ ol.
beforehand = antaŭe.
beg (entreat) = peti.
beg (alms) = almozon peti.
beggar = almozulo.
beggary = almozpeto.
begin = ek, komenci.
beginning (origin) = deveno.
begone! = for de tie ĉi!
beguile (deceive) = trompi.
beguile = amuzi.
behalf = parto.
behave = konduti.
behaviour = konduto.
behead = senkapigi.
behind (prep.) = post.
behind (adv.) = poste.
behold = rigardi.
beholder = rigardanto.
behoof = profito.
being = estaĵo.
belabour = bategi.
belch = rukti.
belfry = sonorilejo.
belgian = belgo.
belgium = belgujo.
belie = kalumnii.
belief = kredo.
believe = kredi.
bell = sonorilo.
bell (door, etc.) = sonorileto.
bell (ornament) = tintilo.
bell ringer = sonorigisto.
belladonna = beladono.
belle = belulino.
bellow = blekegi.
bellows = blovilo.
belly = ventro.
belong = aparteni.
below (adv.) = sube, malsupre.
below (prep.) = sub.
belt = zono.
bench (seat) = benko.
bench (work) = stablo.
bench (of judges) = juĝistaro.
bend = fleksi.
beneath = sub.
benediction = beno.
benefactor = bonfaristo.
beneficial = profita.
benefit = profito.
benevolence = bonfaro.
bent = kurba.
benumb = rigidigi.
bequeath = testamenti.
bequest = heredaĵo.
bereave (of) = senigi (je).
berry = bero.
berth (ship) = kuŝejo.
beseech = petegi.
beset = ĉirkaŭi.
beside = apud.
besides = krom.
besiege = sieĝi.
besot = bestiĝi.
besprinkle = ŝprucigi sur.
best (adj.) = la plej bona.
best (adv.) = la plej bone.
bestial = besta.
bestir, one's self = sin movetadi, vigliĝi.
bestow = donaci.
bet = veti.
bet = veto.
betimes = frue.
betray = perfidi.
betroth = fianĉigi.
betrothing = fianĉiĝo.
better (adj.) = pli bona.
better (adv.) = pli bone.
between = inter.
bevel = tranĉi oblikve.
beverage = trinkaĵo.
bewail = ploregi.
bewilder = konfuzi.
bewitch = ensorĉi.
bewitchment = ensorĉo.
beyond = preter.
beyond (across) = trans.
biassed = partia.
bible = biblio.
biblical = biblia.
bicker = disputi.
bicycle = biciklo.
bid (good day, etc.) = diri.
bid (at auction) = pliproponi.
bid (order) = ordoni.
bidding = invito.
bide = atendi.
bifurcation = disduiĝo.
big = granda.
bigamy = bigamio.
bigot = fanatikulo.
bigotry = fanatikeco.
bilberry = mirtelo.
bile = galo.
bilious = gala.
bill (a/c) = kalkulo.
bill (of exchange) = kambio.
bill (beak) = beko.
bill (posted up) = afiŝo.
bill-poster = afiŝisto.
billhook = branĉhakileto.
billet (note) = letereto.
billet (wood) = ŝtipo.
billiard-ball = globo.
billiards = bilardo.
billow = ondego.
bin = grenkesto.
bind = ligi.
bind (books) = bindi.
bind (together) = kunligi.
bind (wounds) = bandaĝi.
bind-weed = liano.
biography = biografio.
biology = biologio.
biped = dupiedulo.
birch (tree) = betulo.
bird = birdo.
birth = naskiĝo.
birthday = naskotago.
biscuit = biskvito.
bisect = bisekcii.
bishop = episkopo.
bismuth = bismuto.
bit (piece) = peco.
bit (horse) = enbuŝaĵo.
bite = mordi.
bitter = akra—ema.
bitters = vermuto.
bitumen = terpeĉo.
bivouac = bivako.
blab = babili.
black = nigra.
blackboard = nigra tabulo.
black-currant = nigra ribo.
black pudding = sangokolbaso.
blackbird = merlo.
blacken = nigrigi.
blackguard = sentaŭgulo.
blacking = ciro.
blackish = dubenigra.
blacksmith = forĝisto.
bladder = veziko.
blade (grass) = trunketo.
blade (knife) = tranĉanto.
blamable = mallaŭdinda.
blame = mallaŭdi.
blanch = paliĝi.
bland = afabla.
blanket = lankovrilo.
blaspheme = blasfemi.
blast = blovego.
blaze = flamegi.
bleach = blankigi.
bleat = bleki.
bleed (trans.) = sangeltiri.
bleed (intrans.) = sangadi.
blemish = makulo.
blend = miksi.
bless = beni.
blessing = beno—ado.
blight = velkigi.
blind = blinda.
blind, window = rulkurteno.
blindness = blindeco.
blind-alley = senelirejo.
bliss = feliĉegeco.
blister = veziko.
blister (plaster) = vezikigilo.
blithe = gaja.
bloat = ŝveli.
block (pulley) = rulbloko.
block (log) = ŝtipo.
blockade = blokado.
blockhead = malsaĝulo.
blond = blonda.
blood = sango.
bloodshed = sangverŝo—ado.
bloodvessel = sangvejno.
bloom = flori.
blossom = flori.
blot = makulo.
blotch = skabio.
blotting paper = sorba papero.
blow (stroke) = bato.
blow = blovi.
blouse = kitelo.
blow (of flowers) = ekflori.
bludgeon = bastonego.
blue = blua.
bluish = dubeblua.
blunder = erarego.
blunt = malakra.
blunt (mannered) = malafabla.
blur = malpurigi.
blush = ruĝiĝi.
bluster = fanfaroni.
boa = boao.
boar = porkviro.
board (food) = nutrado—aĵo.
board (plank) = tabulo.
board = loĝi.
boarder (house) = loĝanto.
boarder (school) = edukato.
boarding school = edukejo.
boarding-house = loĝantejo.
boast = fanfaroni.
boast = fanfarono.
boaster = fanfaronulo.
boat = boato.
boatman = boatisto.
boat-hook = hokstango.
boat-race = ŝipkurado.
boat (rowing) = remboato.
bobbin = bobeno.
body = korpo.
bog = marĉego.
bohemian = bohemo.
boil (blain) = furunko.
boil = boli.
boiler (saucepan) = bolpoto.
boiler = bolegilo.
boisterous = perforta.
bold = maltima.
boldness = maltimo.
bolster = kapkuseno.
bolt = rigli.
bolt = riglilo.
bomb = bombo.
bombard = bombardi.
bonbon = bombono.
bond (finance) = obligacio.
bondage = servuto.
bondman = vasalo.
bondservant = servutulo.
bondsman (surety) = garantianto.
bone = osto.
bonnet = ĉapo.
bonny = beleta.
bonus = liberdonaco.
booby = simplanimulo.
book = libro.
book-keeper = librotenisto.
book (copy-book) = kajero.
bookseller = libristo.
boom = soni.
booming = sonado.
boon = bonfaro, gajno.
boorish = maldelikata.
boot = boto.
booth = budo.
bootless = neprofita.
bootmaker = botisto.
booty = akiraĵo.
borax = borakso.
border (edge) = randaĵo.
border, to put a = borderi.
bore (a hole) = bori.
bore (of a gun) = kalibro.
borer (tool) = borilo.
born, to be = naskiĝi.
born again = renaskiĝi.
borne = portita.
borough = urba distrikto.
borrow = prunto preni.
bosom = brusto.
botany = botaniko.
botch (spoil) = malbonigi.
both = ambaŭ.
bother = enui.
bottle = botelo.
bottom = fundo.
bottom = malsupro.
bough = branĉo.
bouillon = buljono.
boulder = ŝtonego.
bounce = salti.
bound = salti.
bound = salto.
boundary = limo.
bounden = deviga.
bountiful = malavara.
bounty = helpa mono.
bouquet = bukedo.
bourn = limo.
bout (contest) = konkurso.
bow = saluti.
bow = saluto.
bow = pafarko.
bow (violin) = arĉo.
bow (ribbons) = banto.
bowels = internaĵo.
bower = laŭbo.
bowl = pelvo.
box (small) = skatolo.
box = kesto.
box, money = monoskatoleto.
box (shrub) = bukso.
box (theatre) = loĝio.
box = pugnebati.
boy = knabo.
brace = paro.
bracelet = ĉirkaŭmano.
braces = ŝelko.
bracket = tableto.
brackish = saleta.
bray = fanfaroni.
braggart = fanfaronulo.
brain = cerbo.
brake (fern) = filiko.
brake (for wheels) = haltigilo.
bran = brano.
branch (of tree) = branĉo.
branch (of roads, etc.) = disvojo.
brand (fire) = brulaĵo.
brandish = svingi.
brandy = brando.
brasier = fajrujo.
brass = flava kupro.
brave = brava.
brave = bravulo.
brave = kontraŭstari al.
bravery = braveco.
bravo! = brave!
brawl = malpacego.
brawny = muskola.
bray (ass) = bleki.
bray (to pound) = pisti.
brazen = bronza.
breach = breĉo.
bread = pano.
bread (unleavened) = maco.
breadth = larĝeco.
break = rompi.
break off = disrompi.
break, to pieces = frakasi.
breakfast = matenmanĝi.
bream = bramo.
breast = brusto.
breast = mamo.
breath = elspiraĵo.
breathe = spiri.
breathe (heavily) = stertori.
breathing = spirado.
breech (of gun) = ŝargujo.
breeches = pantalono.
breed (race) = raso.
breeze = venteto.
brevity = mallongeco.
brew = bierfari.
brewer = bierfaristo.
brewery = bierfarejo.
bribe = subaĉeti.
brick = briko.
brick (fire) = fajrŝtono.
bride = novedzino.
bridge = ponto.
bridle = brido.
brief = mallonga.
brier = rozo sovaĝa.
brigade = brigado.
brigand = rabisto.
brigandage = rabado.
bright (clear) = hela.
bright, to get = heliĝi.
brighten = briligi.
brighten (polish) = poluri.
brightness = brilo.
brilliant = brila.
brilliant (jewel) = brilianto.
brimful = plenpota.
brine = peklakvo.
bring = alkonduki.
bring back = rekonduki.
bring down (of prices) = rabati.
bring forth (a child) = naski.
bring up (a child) = elnutri.
brink = rando.
briny = sala.
brisk (lively) = vigla.
brisk (quick) = rapida.
briskness = rapideco.
bristle = harego.
brittle = facilrompa.
broach = trapiki.
broad = larĝa.
brochure = broŝuro.
broil = rosti.
broker = makleristo.
broker, to act as = makleri.
brokerage = maklero.
bromine = bromo.
bronchitis = bronkito.
bronchial = bronka.
brooch = broĉo.
brood (fowl) = kovi.
brook = rivereto.
broth = buljono.
broom (sweeping) = balailo.
broom (shrub) = ŝtipo.
brother = frato.
brotherhood = frateco.
brotherly = frata.
brougham = kaleŝo.
brown = bruna.
brownish = dubebruna.
browse = sin paŝti.
bruise (crush) = pisti.
bruise = kontuzi.
bruit = bruego.
brush = broso.
brutal = bruta.
brute = bruto.
buccaneer = marrabisto.
bucket = sitelo.
buckle = buko.
buckler = ŝildo.
buckwheat = poligono.
bud = burĝono.
budget (finance) = budĝeto.
buffalo = bubalo.
buffer = ŝtopilo.
buffet = frapi.
buffet (restaurant) = bufedo.
buffoon = ŝercemulo.
bug = cimo.
build = konstrui.
building, a = konstruaĵo.
bulb = bulbo.
bulgarian = bulgaro.
bulk = dikeco.
bulky = multdika.
bull = bovoviro.
bullet = kuglo.
bulletin = noto, karteto.
bullfinch = pirolo.
bullion (ingot) = fandaĵo.
bullock = juna bovoviro.
bulwark = remparo.
bump = ĝibeto.
bumper = plenglaso.
bun = bulko.
bunch (cluster) = aro.
bundle = fasko.
bung = ŝtopilo.
bungle = fuŝi.
buoy = naĝbarelo.
buoyant = naĝema.
burden = ŝarĝo.
burden (refrain) = rekantaĵo.
burden = ŝargi.
burdensome = multepeza.
bureau (office) = oficejo.
burgess = burgo.
burglar = domorabisto.
burial = enteriĝo.
buried, to be = enteriĝi.
burn (trans.) = bruligi.
burn (intrans.) = bruli.
burner (gas) = flamingo.
burnish = poluri.
burrow = kavigi.
bury (something) = enfosi.
bury (inter.) = enterigi.
bush = arbetaĵo.
bushel = buŝelo.
buskin = duonboto.
business (profession) = profesio.
business (in general) = afero.
business-man = aferisto.
bust = busto.
bustle = movo,—ado.
busy = okupa.
but = sed.
but (prep.) = krom.
butcher = buĉisto.
butler = kelisto.
butt (end of gun) = kapo de la pafilo.
butter = butero.
butterfly = papilio.
button (verb) = butonumi.
button-hook = butonumilo.
button = butono.
button-hole = butontruo.
buy = aĉeti.
by means of = per.




cab = fiakro.
cabal = kabalo.
cabbage = brasiko.
cabin = kajuto, ĉambreto.
cabinet (room) = ĉambreto.
cabinet (ministry) = kabineto.
cabinet-maker = meblisto.
cabinet-making = meblofarado.
cable = ŝnurego.
cackle = pepegi.
cacophony = malbonsoneco.
cadence = kadenco.
cadet = kadeto.
café (coffee house) = kafejo.
cage = kaĝo.
cajoler = delogisto.
cake = kuko.
calcine = pulvorigi.
calculate = kalkuli.
calculation = kalkulo.
caldron = kaldrono.
calendar = kalendaro.
calf = bovido.
calf (of leg) = tibiviando.
calibre = kalibro.
calico = kalikoto.
calk = kalfatri.
call = voki.
call on (visit) = viziti.
call (a meeting) = kunvoki.
call = voko.
call (visit) = vizito.
caller (visitor) = vizitanto.
calling = profesio.
callous = kala.
callosity = kalo.
calm = kvietigi.
calm = kvieta.
calm = trankvila.
calmness = kvieteco.
calumniate = kalumnii.
calumny = kalumnio.
camel = kamelo.
camelia = kamelio.
camisole = kamizolo.
camomile = kamomilo.
camp = tendaro.
campaign = militiro.
camphor = kamforo.
can (vb.) = povas.
canal = kanalo.
canary = kanario.
cancel (erase) = surstreki.
cancel (nullify) = nuligi.
candelabrum = kandelabro.
candid = simplanima.
candid = naiva.
candidate (political) = kandidato.
candidate = aspiranto.
candidature = kandidateco.
candle = kandelo.
candlestick = kandelingo.
candour = verdiremo, sincereco. [error in book: sinsereco]
candy = kando.
cane = kano.
cane (walking stick) = bastono.
cane = vergi.
canine = huna.
canker = mordeti.
cannibal = hommanĝulo.
cannon = pafilego.
cannon (at billiards, etc.) = karamboli.
cannonade = pafilegado, bombardado.
canon = kanono.
canopy = baldakeno.
cant = hipokrito.
canteen = drinkejo.
canter = galopeti.
canticle = himno.
canto = versaro.
canton = kantono.
canvas = kanvaso.
canvass = subpostuli.
cap = ĉapo.
cap (military) = kepo.
capability = kapableco.
capable = kapabla.
capacious = vasta.
capacity = enhavebleco.
cape = promontoro.
capital (city) = ĉefurbo.
capital (money) = kapitalo.
capital letter = granda litero.
capital (of a column) = kapitelo.
capitalist = kapitalisto.
capitulate = kapitulaci.
capitulation = kapitulaco.
capon = kapono.
caprice = kaprico.
capsize = renversiĝi.
captain (ship) = ŝipestro.
captain (milit.) = kapitano.
captive = malliberulo.
captive = mallibera.
captivate (charm) = ĉarmegi.
captivity = mallibereco.
capture = preno.
capuche = kapuĉo.
car = ĉaro.
car (of balloon) = korbego.
carabine = karabeno.
carafe = karafo.
carat = karato.
caravan = karavano.
carbon = karbono.
carbuncle = karbunkolo.
card = karto.
card (playing) = ludkarto.
card (visiting) = karteto.
cardboard = kartono.
cardinal = kardinalo.
cardinal (adj.) = ĉefa.
care = zorgo.
care of, take = zorgi pri.
careful = zorga.
careless = senzorga.
caress = karesi.
caress = kareso.
cargo = ŝarĝo.
carman = veturigisto.
carmine = karmino.
carnage = buĉado.
carnation (flower) = dianto.
carnation (color) = flavroza.
carnival = karnavalo.
carnivorous = viandomanĝanta.
caricature = karikaturi.
carousal = karuselo.
carp = karpo.
carpenter = ĉarpentisto.
carpentering, to do = ĉarpenti.
carpet = tapiŝo.
carriage = veturilo.
carriage (railway) = vagono.
carriage (cost) = transsenda pago.
carriage (of goods) = transporto.
carrion = mortintaĵo.
carrot = karoto.
carry = porti.
carry away = forporti.
carry back = reporti.
carry off (by force) = rabi, forrabi.
carry (by vehicle) = veturigi.
cart = veturigi.
cart = ŝarĝoveturilo.
carter = veturigisto.
cartilage = kartilago.
cartridge = kartoĉo.
cartridge-box = kartoĉujo.
cartwright = veturilfaristo.
carve (sculpture) = skulpti.
carve (cut) = tranĉi, detranĉi.
cascade = kaskado.
case (gram.) = kazo.
case (cover) = ingo.
case (in court) = proceso.
casement = kazemato.
cash = mono.
cash (ready) = kontanto.
cashier = kasisto.
cask = barelo.
casket = skatoleto.
cassock = pastra vesto.
cast (throw) = ĵeti.
cast (iron, etc.) = fandi.
cast (skin, etc.) = ŝanĝi felon.
cast out = elĵeti.
cast lots = loti.
castaway = forĵetulo.
castellan = kastelestro.
caster = radeto.
casting = fandaĵo.
castigate (with a rod) = vergi.
cast-iron = ferfandaĵo.
castle = kastelo.
castrate = kastri.
castration = kastro.
casual = okaza.
casually = okaze.
casuality = okazeco.
cat = kato.
catacombs = subteraj galerioj.
catafalque = katafalko.
catalepsy = katalepsio.
catalogue = katalogo.
cataract (eyes) = katarakto.
catarrh = kataro.
catch = kapti.
catechise = kateĥizi.
catechism = kateĥismo.
catechist = kateĥisto.
category = kategorio.
cater = provizi.
caterpillar = raŭpo.
cathedral = katedro.
catholic = katoliko.
catholicism = katolikismo. [error in book: katolicismo]
cattle = bestaro.
cattle-pen = bestejo.
caudal = vosta.
cauldron = kaldrono.
cauliflower = florbrasiko.
cause = kaŭzo.
cause = kaŭzi.
cause = igi.
cauterize = kaŭterizi.
caution = averti.
caution = singardemo.
cautious = singardema.
cavalcade = rajdantaro.
cavalier = rajdanto.
cavalry = kavalerio.
cave = kaverno.
caviare = kaviaro.
cavil = ĉikani.
cavity = kavo, kavaĵo.
cease = ĉesi.
cedar = cedro.
cede = cedi.
ceiling = plafono.
celebrate (feast) = festi.
celebrate (solemnize) = solenigi.
celebrated = fama.
celerity = rapideco.
celery = celerio.
celestial = ĉiela.
celibacy = fraŭleco.
cell (of honeycomb) = ĉelo.
cellar = kelo.
cellular = ĉela.
cement = cemento.
cemetery = tombejo.
censer = bonodorfumilo.
censor = cenzuristo.
censorious = cenzura.
censure = cenzuri.
censure (blame) = riproĉo.
census (take a) = sumigi.
cent = cendo.
centenarian = centjarulo.
centenary = centjara festo.
centigramme = centigramo.
centime = centimo.
centimeter = centimetro.
central = meza, centra.
centralize = alcentrigi.
centre = centro.
centre-bit = turnborilo.
centrifugal = decentrokura.
centripetal = alcentrokura.
century = centjaro.
ceremonious = ceremonia.
ceremony = ceremonio.
certain (some) = kelkaj.
certain (sure) = certa.
certainly = certe, nepre.
certainty = certeco.
certify = certigi.
certify = atesti.
certitude = certeco.
cessation (of hostilities) = interpaco.
cessation = ĉesado.
cession = cedo.
cetaceous = balena.
chaff (ridicule) = moki.
chaff = pajlrestaĵo.
chaffinch = fringo.
chagrin = ĉagreno.
chain = ĉeno.
chain of mountains = montaro.
chair = seĝo.
chairman = prezidanto.
chaise = veturileto.
chalice = kaliko.
chalk = kreto.
chalky = kreteca.
challenge, to = ekciti, al.
chamber = ĉambro.
chambermaid = ĉambristino.
chamberlain = ĉambelano.
chameleon = kameleono.
chamois = ĉamo.
chamois-leather = ŝamo.
champagne = ĉampano.
champion = probatalanto.
chance = hazardo.
chance (to happen) = okazi.
chancel = ĥorejo.
chancellor = kanceliero.
chandelier = lustro.
change = ŝanĝi.
changeable = ŝanĝebla.
channel = kanalo.
chant = kantado.
chaos = ĥaoso.
chaotic = ĥaosa.
chapel = kapelo.
chaplain = ekleziulo.
chapter = ĉapitro.
char = bruleti.
character = karaktero.
character (theatre) = rolo.
characterize = karakterizi.
charge (attack) = atakegi.
charge (price) = kosto.
chariot = ĉaro.
charitable = bonfarada.
charity = bonfarado.
charity (alms) = almozo.
charlatan = ĉarlatano.
charm = ĉarmi.
charm = ĉarmo.
charm = talismano.
charming = ĉarma.
charnel house = karnejo.
chart (geog.) = karto geografia.
chase = ĉasi.
chase = ĉaso.
chaste = ĉasta.
chasten = korekti.
chastise = puni.
chastisement = puno.
chastity = ĉasteco.
chasuble = mesvesto.
chat = interparoleti.
chattels = bieno.
chatter = babili.
cheap = malkara.
cheat = trompi.
cheat (trick) = trompo.
cheat (deceiver) = trompanto.
check (restrain) = haltigi.
check = kontraŭmarki.
cheek = vango.
cheekbone = vangosto.
cheer = aplaŭdegi.
cheer = konsoli.
cheerful = gaja.
cheerfulness = gajeco.
cheer up = rekuraĝigi.
cheese = fromaĝo.
chemise = ĉemizo.
chemist = apotekisto.
chemist-shop = apoteko.
chemistry = ĥemio.
cheque = ĉeko.
cherry = ĉerizo.
cherub = kerubo.
chess-pieces = ŝakoj.
chess-board = ŝaka tabulo.
chest of drawers = komodo.
chest (box) = kesto.
chest = brusto.
chestnut (edible) = kaŝtano.
chevalier = kavaliro.
chew = maĉi.
chicane = ĉikani.
chicken = kokido.
chicken-house = kokejo.
chicory = cikorio.
chide = riproĉi.
chief = ĉefo.
chief = ĉefa.
chiffonier = ĉifonujo.
chignon = harligaĵo.
chilblain = frostabsceso.
child = infano.
childhood = infaneco.
childish = infana.
childishness = infanaĵo.
chill = malvarmigi.
chill = malvarmo.
chime = sonorilado.
chimera = ĥimero.
chimney = kamentubo.
chimney-sweep = kamentubisto.
chin = mentono.
china = ĥinujo, ĥinlando.
china = porcelano.
chinese (man) = ĥino.
chink = tinti.
chink (crack) = fendaĵo.
chirp = pepi.
chisel = ĉizi.
chisel = ĉizilo.
chivalrous = kavalira.
chivalry = kavalireco.
chocolate = ĉokolado.
choice = elekto.
choir = ĥoro.
choke = sufoki.
choke up = obstrukci.
choler = kolero.
cholera = ĥolero.
choleric = kolera.
choose = elekti.
chop = haki.
chop down = dehaki.
chopper = hakilo.
choral = ĥora.
chorister = ĥoristo.
chorus = ĥoraro.
chrism = sankta oleo.
christ = kristo.
christen = bapti.
christendom = kristanaro.
christian = kristano.
christian-name = baptonomo.
